XXXXXXXXXXXXXXX
XE___X________X
X_oX__X_XX_X_XX
X_X_X___XX____X
XXXX_XX_XX_XX_X
XX______Xo____X
X__X__oXX___X_X
X_X_X_X_XX__oSX
XXXXXXXXXXXXXXX
