XXXXXXXXXXXXXXXXXXXXX
XE____________X_X___X
X______X____________X
X____X_XX____X_X___XX
XXo__________o_X____X
X______XX____X___X_XX
Xo________X__X_X__X_X
Xo_______X____X_____X
X____X_X_________X_oX
X_______X______oX_X_X
XX_____X_XX____XXX__X
X______X_______X____X
XX__________________X
X___X_____X__X______X
XXX__X______________X
X_o___XX___X___X__oSX
XXXXXXXXXXXXXXXXXXXXX
