XXXXXXXXXXXXXXXXXXXX
XE___X_X__oX___o___X
XX_Xo___X___o_____XX
X_X____X____X_X___XX
X___oXX__o____o___oX
X_XX_____X_____o___X
X______X__X________X
X__X_______X____X_XX
X_XXX____X_X______XX
Xo___o__________X__X
X______o__X______XSX
XXXXXXXXXXXXXXXXXXXX
