XXXXXXXXXXXXXXXXXXXXXXXX
XEX__X_________________X
X___________X__X_o_____X
X_o__________________o_X
Xo________o_______o____X
X______________________X
X________X_____________X
X____________X_________X
X__X_________X________SX
XXXXXXXXXXXXXXXXXXXXXXXX
